{
	"elements": {
		"0": [
            "##################################################",
            "#000000000000000000000000000000000000000000000000#",
            "#000000000000000000000000000000000000000000000000#",
            "#000000000000000000000000000000000000000000000000#",
            "#000000000000000000000000000000000000000000000000#",
            "#000000000000000000000000000000000000000000000000#",
            "#000000000000000000000000000000000000000000000000#",
            "#000000000000000000000000000000000000000000000000#",
            "#000000000000000000000000000000000000000000000000#",
            "#000000000000000000000000000000000000000000000000#",
            "#000000000000000000000000000000000000000000000000#",
            "#000000000000000000000000000000000000000000000000#",
            "#000000000000000000000000000000000000000000000000#",
            "#000000000000000000000000000000000000000000000000#",
            "#000000000000000000000000000000000000000000000000#",
            "#000000000000000000000000000000000000000000000000#",
            "#000000000000000000000000000000000000000000000000#",
            "#000000000000000000000000000000000000000000000000#",
            "#000000000000000000000000000000000000000000000000#",
            "#000000000000000000000000000000000000000000000000#",
            "#000000000000000000000000000000000000000000000000#",
            "#000000000000000000000000000000000000000000000000#",
            "#000000000000000000000000000000000000000000000000#",
            "#000000000000000000000000000000000000000000000000#",
            "#000000000000000000000000000000000000000000000000#",
            "#000000000000000000000000000000000000000000000000#",
            "#000000000000000000000000000000000000000000000000#",
            "#000000000000000000000000000000000000000000000000#",
            "#000000000000000000000000000000000000000000000000#",
            "#000000000000000000000000000000000000000000000000#",
            "#000000000000000000000000000000000000000000000000#",
            "#000000000000000000000000000000000000000000000000#",
            "#000000000000000000000000000000000000000000000000#",
            "#000000000000000000000000000000000000000000000000#",
            "#000000000000000000000000000000000000000000000000#",
            "#000000000000000000000000000000000000000000000000#",
            "#000000000000000000000000000000000000000000000000#",
            "#000000000000000000000000000000000000000000000000#",
            "#000000000000000000000000000000000000000000000000#",
            "#000000000000000000000000000000000000000000000000#",
            "#000000000000000000000000000000000000000000000000#",
            "#000000000000000000000000000000000000000000000000#",
            "#000000000000000000000000000000000000000000000000#",
            "#000000000000000000000000000000000000000000000000#",
            "#000000000000000000000000000000000000000000000000#",
            "#000000000000000000000000000000000000000000000000#",
            "#000000000000000000000000000000000000000000000000#",
            "#000000000000000000000000000000000000000000000000#",
            "#000000000000000000000000000000000000000000000000#",
            "######################000000######################"
        ],
      "1": [
            "######################000000######################",
            "#000000000000000000000000000000000000000000000000#",
            "#000000000000000000000000000000000000000000000000#",
            "#000000000000000000000000000000000000000000000000#",
            "#000000000000000000000000000000000000000000000000#",
            "#000000000000000000000000000000000000000000000000#",
            "#000000000000000000000000000000000000000000000000#",
            "#000000000000000000000000000000000000000000000000#",
            "#000000000000000000000000000000000000000000000000#",
            "#000000000000000000000000000000000000000000000000#",
            "#000000000000000000000000000000000000000000000000#",
            "#000000000000000000000000000000000000000000000000#",
            "#000000000000000000000000000000000000000000000000#",
            "#000000000000000000000000000000000000000000000000#",
            "#000000000000000000000000000000000000000000000000#",
            "#000000000000000000000000000000000000000000000000#",
            "#000000000000000000000000000000000000000000000000#",
            "#000000000000000000000000000000000000000000000000#",
            "#000000000000000000000000000000000000000000000000#",
            "#000000000000000000000000000000000000000000000000#",
            "#000000000000000000000000000000000000000000000000#",
            "#000000000000000000000000000000000000000000000000#",
            "#000000000000000000000000000000000000000000000000#",
            "#000000000000000000000000000000000000000000000000#",
            "#000000000000000000000000000000000000000000000000#",
            "#000000000000000000000000000000000000000000000000#",
            "#000000000000000000000000000000000000000000000000#",
            "#000000000000000000000000000000000000000000000000#",
            "#000000000000000000000000000000000000000000000000#",
            "#000000000000000000000000000000000000000000000000#",
            "#000000000000000000000000000000000000000000000000#",
            "#000000000000000000000000000000000000000000000000#",
            "#000000000000000000000000000000000000000000000000#",
            "#000000000000000000000000000000000000000000000000#",
            "#000000000000000000000000000000000000000000000000#",
            "#000000000000000000000000000000000000000000000000#",
            "#000000000000000000000000000000000000000000000000#",
            "#000000000000000000000000000000000000000000000000#",
            "#000000000000000000000000000000000000000000000000#",
            "#000000000000000000000000000000000000000000000000#",
            "#000000000000000000000000000000000000000000000000#",
            "#000000000000000000000000000000000000000000000000#",
            "#000000000000000000000000000000000000000000000000#",
            "#000000000000000000000000000000000000000000000000#",
            "#000000000000000000000000000000000000000000000000#",
            "#000000000000000000000000000000000000000000000000#",
            "#000000000000000000000000000000000000000000000000#",
            "#000000000000000000000000000000000000000000000000#",
            "#000000000000000000000000000000000000000000000000#",
            "######################000000######################"
        ]
	},
    "layout": [
        {"Id": "start", "bottom": "1", "element": "0"},
        {"Id": "1", "element":"1"}
    ]
}